1 2 3 0 0 12 0 0
4 5 6 0 0 0 0 0
0 7 0 0 0 0 0 13
0 0 0 0 11 0 0 0
0 14 0 0 0 0 0 0
8 9 10 0 0 0 0 0