1 2 3 0 0 0 12 0
4 5 6 0 11 0 0 0
0 7 0 0 0 0 0 13
0 0 0 0 37 38 0 0
48 14 49 0 0 0 0 0
8 9 10 0 0 39 0 0