17 18 17 19 17 20 17 25
15 21 15 22 15 23 15 24
40 41 42 40 41 42 15 40
15 15 15 15 15 15 15 15
43 44 45 46 15 15 15 42
15 15 15 15 15 47 16 15