17 18 17 19 17 20 17 17
15 21 15 22 15 23 15 15
15 15 15 15 15 15 15 15
25 17 17 17 17 17 15 15
24 15 15 15 15 15 15 15
15 15 15 15 15 15 16 15