28 29 28 28 26 26 26 35
26 30 26 26 26 26 34 33
26 26 26 26 26 26 26 36
27 26 26 26 26 26 26 26
26 26 26 26 26 32 26 26
26 26 35 26 26 31 26 36