17 18 17 19 17 20 17 25
15 21 15 22 15 23 15 24
15 15 15 15 15 15 15 15
17 17 17 17 17 17 15 15
15 15 15 15 15 15 15 15
15 15 15 15 15 15 16 15